   WE                            textures/wolfenstein/eagle.xpm 
NO      textures/wolfenstein/grey_stone.xpm



SO textures/wolfenstein/red_brick.xpm

F   69, 222, 199

EA textures/wolfenstein/mossy.xpm



C 235, 198, 52

111111111111111111111111
100000000000000000000001
100000000000000000000001
100000000E0000C000000001
100000000000000000000001
100000000000000000000001
100000000000000000000001
100000111110000101010001
100000100010000000000001
1000001C00D0000100010001
100000100010000000000001
100000111110001010100001
100000000000000000000001
100000000000000000000001
100000000000000000000001
100000000000000000000001
100000000000000000000001
100000000000000000000001
100000000000000000000001
111111111000000000000001
100100001000000000000001
100D001C1000000000000001
100100001000000000000001
100111111000000000000001
10000000000000000C000001
100000000000000000000001
111111111111111111111111
