NO textures/brickwall1.xpm
SO textures/brickwall2.xpm
WE textures/brickwall3.xpm
EA textures/brickwall5.xpm

F 48,20,20
C 20,20,20

111111111111111111111111
1D0000000010000000000001
1011110110101111D1111101
101001000010010000001001
101001011110100111110101
1010010000001000C0000101
101111011010101111011101
100000000010000000000001
11111C1111111111D1111111
1000100000100000000000D1
101110111010101011111101
101000001010001000000101
101011101011101011110101
1010100010D0101000010101
101110111110101111010101
1000000000D0100000000001
11101111111D111011111111
1S0010000010001000000001
101110101011101110111101
101000101000001000100001
101D11101111111011101111
101C10000000000000001001
1D0101110111111101110101
100000C00000000010000001
111111111111111111111111
